Grapheme	IPA
^	NULL
$	NULL
_	_
►	NULL
a	a
ŋ	ŋ
ŋh	ŋ h
ŋw	ŋ w
ø	ø
ħ	ħ
aː	aː
b	b
bw	b w
^bw	bʷ
c	c
d	d
dw	d w
dʰ	dʰ
e	e
ʀ	ʀ
ʊ	ʊ
ʌ	ʌ
ɑ	ɑ
ɑː	ɑː
ɔ	ɔ
ɛ	ɛ
ɡ	ɡ
ɡɡ	ɡɡ
ɡw	ɡʷ
ɡʰ	ɡʰ
ʤ	ʤ
ɣ	ɣ
ɽ	ɽ
ɾ	ɾ
ɾh	ɾ h
ɾs	ɾ s
ɾw	ɾ w
ɲ	ɲ
ɳ	ɳ
eː	eː
ɪ	ɪ
f	f
h	h
hw	h w
hⁿ	hⁿ
I	i
i	i
β	β
iː	iː
j	j
jw	j w
k	k
ks	k s
kw	kw
kʰ	kʰ
l	l
m	m
ms	m s
mw	m w
^mb	ᵐb
N	n
Ng	n ɡ
Nf	n f
ns	n s
n	n
nh	n h
nw	n w
o	o
oː	oː
oo	oː
p	p
pʰ	pʰ
s	s
sw	s w
s j
t	t
tʰ	tʰ
tʃ	tʃ
ts	ts
tw	t w
U	u
u	u
uː	uː
v	v
w	w
y	y
ʔʰ	ʔʰ
